
NO ./textures/1.xpm
SO ./textures/2.xpm
WE ./textures/3.xpm
EA ./textures/4.xpm


F 0,51,0
C 110,197,255

111111111111111111111111111111111111111111111111111111
1111000001111111100000000000111100000000000000111 
111100000001111111100000000000111110001000000101
100000000000000000001111100011100000011100011111
1111100000010000N000001111100011110000011100001
10000000100000000001111100011110000011100001111
1111111111111110000000000000000000000000111
11000000000000000000000000110000000000001111
11000000000000000001111100001100000011100001
1000011110000000001111000000000000111000011111
10000000000011110000000000011110000011100001
10000000000011110000000000011110000000000001
10000000000000000001111100001100000011100011
10000111100000000001111100000000000011111001111
110000010100001111000000000011110000011100001
11111111111111 11111111111111 1111111111111111